7 7
@ @ @ @ @ @ @
@ . . . . @ @
@ . . . . @ @
@ . . . . . @
@ @ @ @ . . @
@ @ @ @ @ @ @
@ @ @ @ @ @ @
2
2 1 3 5
1 2 4 4
