10 10
@ @ @ @ @ @ @ @ @ @
@ . . . . . . . @ @
@ . . . . . . . @ @
@ . . . . . . . @ @
@ . . . . . . . @ @
@ . . . . . . . @ @
@ . . . . . . . . @
@ @ @ @ @ @ @ . . @
@ @ @ @ @ @ @ @ @ @
@ @ @ @ @ @ @ @ @ @
2
2 1 6 8
1 2 7 7
