12 12
@ @ @ @ @ @ @ @ @ @ @ @
@ . . . . . . . . . @ @
@ . . . . . . . . . @ @
@ . . . . . . . . . @ @
@ . . . . . . . . . @ @
@ . . . . . . . . . @ @
@ . . . . . . . . . @ @
@ . . . . . . . . . @ @
@ . . . . . . . . . . @
@ @ @ @ @ @ @ @ @ . . @
@ @ @ @ @ @ @ @ @ @ @ @
@ @ @ @ @ @ @ @ @ @ @ @
2
2 1 8 10
1 2 9 9
