9 9
@ @ @ @ @ @ @ @ @
@ . . . . . . @ @
@ . . . . . . @ @
@ . . . . . . @ @
@ . . . . . . @ @
@ . . . . . . . @
@ @ @ @ @ @ . . @
@ @ @ @ @ @ @ @ @ 
@ @ @ @ @ @ @ @ @ 
2
2 1 5 7
1 2 6 6
