11 11
@ @ @ @ @ @ @ @ @ @ @
@ . . . . . . . . @ @
@ . . . . . . . . @ @
@ . . . . . . . . @ @
@ . . . . . . . . @ @
@ . . . . . . . . @ @
@ . . . . . . . . @ @
@ . . . . . . . . . @
@ @ @ @ @ @ @ @ . . @
@ @ @ @ @ @ @ @ @ @ @
@ @ @ @ @ @ @ @ @ @ @
2
2 1 7 9
1 2 8 8
