8 8
@ @ @ @ @ @ @ @
@ . . . . . @ @
@ . . . . . @ @
@ . . . . . @ @
@ . . . . . . @
@ @ @ @ @ . . @
@ @ @ @ @ @ @ @
@ @ @ @ @ @ @ @
2
2 1 4 6
1 2 5 5
